. P . . .
# # # # #
. . . . .
. . Q . .
. . . . .