. . . . . . . .
# P . # . . . .
# . . # . . . .
# # # # . . . .
. . . . . . . .
. # # # . . . .
. Q . # # . . .
. . . . . . . .