. . . . . . .
. P . . . . .
. . . . . . .
# # # # . . .
. # . . . . .
. # # # # . .
. Q . . . . .