. . . . . . . . .
. . P . . . . . .
. . # # # . . . .
. . . . . . . . .
. # # . # # # # .
. . . . . . . . .
. # # # # . . . .
. . . Q . . . . .