. P . . .
. # # # .
. . . . .
. . Q . .
. . . . .